1111111111111111111                                                                                                                                     
1.................1                                                                                                                                     
1.................1                                                                                                                                     
1.................1                                                                                                                                     
1.................1                                                                                                                                     
1.................1                                                                                                                                     
1.................1                                                                                                                                     
1.................1                                                                                                                                     
1.................1                                                                                                                                     
1.........P.......1                                                                                                                                     
1.................1                                                                                                                                     
1.................1                                                                                                                                     
1.................1                                                                                                                                     
1.................1                                                                                                                                     
1.................1                                                                                                                                     
1.................1                                                                                                                                     
1.................1                                                                                                                                     
1.................1                                                                                                                                     
111111111..11111111                                                                                                                                     
111111111..111111111111111111111111111                                                                                                                  
1.................11.................1                                                                                                                  
1.................11.................1                                                                                                                  
1.................11.................1                                                                                                                  
1.................11.................1                                                                                                                  
1.................11.................1                                                                                                                  
1.................11.................1                                                                                                                  
1.................11.................1                                                                                                                  
1.................11.................1                                                                                                                  
1.........M.......11.........M.......1                                                                                                                  
1.................11.................1                                                                                                                  
1.................11.................1                                                                                                                  
1.................11.................1                                                                                                                  
1.................11.................1                                                                                                                  
1.................11.................1                                                                                                                  
1.................11.................1                                                                                                                  
1.................11.................1                                                                                                                  
1.................11.................1                                                                                                                  
111111111..11111111111111111..11111111                                                                                                                  
111111111..11111111111111111..111111111111111111111111111                                                                                               
1.................11.................11.................1                                                                                               
1.................11.................11.................1                                                                                               
1.................11.................11.................1                                                                                               
1.................11.................11.................1                                                                                               
1.................11.................11.................1                                                                                               
1.................11.................11.................1                                                                                               
1.................11.................11.................1                                                                                               
1.......................................................1                                                                                               
1.........M..................M..................M.......1                                                                                               
1.................11.................11.................1                                                                                               
1.................11.................11.................1                                                                                               
1.................11.................11.................1                                                                                               
1.................11.................11.................1                                                                                               
1.................11.................11.................1                                                                                               
1.................11.................11.................1                                                                                               
1.................11.................11.................1                                                                                               
1.................11.................11.................1                                                                                               
111111111..111111111111111111111111111111111111..11111111                                                                                               
111111111..111111111111111111111111111111111111..11111111                                                                                               
1.................11.................11.................1                                                                                               
1.................11.................11.................1                                                                                               
1.................11.................11.................1                                                                                               
1.................11.................11.................1                                                                                               
1.................11.................11.................1                                                                                               
1.................11.................11.................1                                                                                               
1.................11.................11.................1                                                                                               
1....................................11.................1                                                                                               
1.........M..................M.......11.........M.......1                                                                                               
1.................11.................11.................1                                                                                               
1.................11.................11.................1                                                                                               
1.................11.................11.................1                                                                                               
1.................11.................11.................1                                                                                               
1.................11.................11.................1                                                                                               
1.................11.................11.................1                                                                                               
1.................11.................11.................1                                                                                               
1.................11.................11.................1                                                                                               
111111111..111111111111111111111111111111111111..11111111                                                                                               
111111111..111111111111111111111111111111111111..11111111                                                                                               
1.................11.................11.................1                                                                                               
1.................11.................11.................1                                                                                               
1.................11.................11.................1                                                                                               
1.................11.................11.................1                                                                                               
1.................11.................11.................1                                                                                               
1.................11.................11.................1                                                                                               
1.................11.................11.................1                                                                                               
1.................11....................................1                                                                                               
1.........M.......11.........B..................M.......1                                                                                               
1.................11.................11.................1                                                                                               
1.................11.................11.................1                                                                                               
1.................11.................11.................1                                                                                               
1.................11.................11.................1                                                                                               
1.................11.................11.................1                                                                                               
1.................11.................11.................1                                                                                               
1.................11.................11.................1                                                                                               
1.................11.................11.................1                                                                                               
11111111111111111111111111111111111111111111111..11111111                                                                                               
                                      111111111..111111111111111111111111111                                                                            
                                      1.................11.................1                                                                            
                                      1.................11.................1                                                                            
                                      1.................11.................1                                                                            
                                      1.................11.................1                                                                            
                                      1.................11.................1                                                                            
                                      1.................11.................1                                                                            
                                      1.................11.................1                                                                            
                                      1....................................1                                                                            
                                      1.........M..................M.......1                                                                            
                                      1.................11.................1                                                                            
                                      1.................11.................1                                                                            
                                      1.................11.................1                                                                            
                                      1.................11.................1                                                                            
                                      1.................11.................1                                                                            
                                      1.................11.................1                                                                            
                                      1.................11.................1                                                                            
                                      1.................11.................1                                                                            
                                      11111111111111111111111111111111111111                                                                            
                                                                                                                                                        
                                                                                                                                                        
                                                                                                                                                        
                                                                                                                                                        
                                                                                                                                                        
                                                                                                                                                        
                                                                                                                                                        
                                                                                                                                                        
                                                                                                                                                        
                                                                                                                                                        
                                                                                                                                                        
                                                                                                                                                        
                                                                                                                                                        
                                                                                                                                                        
                                                                                                                                                        
                                                                                                                                                        
                                                                                                                                                        
                                                                                                                                                        
                                                                                                                                                        
                                                                                                                                                        
                                                                                                                                                        
                                                                                                                                                        
                                                                                                                                                        
                                                                                                                                                        
                                                                                                                                                        
                                                                                                                                                        
                                                                                                                                                        
                                                                                                                                                        
                                                                                                                                                        
                                                                                                                                                        
                                                                                                                                                        
                                                                                                                                                        
                                                                                                                                                        
                                                                                                                                                        
                                                                                                                                                        
                                                                                                                                                        
                                                                                                                                                        
                                                                                                                                                        
